1111111111
1000000011
1000000021
1000000031
1111111111
